{
	"entity_layer": 1,
	
	"tile_pallet": [
		"gen3:void",
		"gen3:tree_md_bottomleft",
		"gen3:tree_md_bottomright",
		"gen3:grass1_variant1",
		"gen3:grass1_variant2",
		"gen3:tree_md_midleft_nobg",
		"gen3:tree_md_midright_nobg",
		"gen3:tree_md_topleft_nobg",
		"gen3:tree_md_topright_nobg",
		"gen3:grass1_variant3",
		"gen3:grass1_variant4",
		"gen3:grass1_variant5",
		"gen3:grass1_variant6",
		"gen3:tallgrass1_base",
		"gen3:fence1_horizontal",
		"gen3:flower1",
		"gen3:sign1",
		"gen3:tallgrass1_top",
		"gen3:path2_n",
		"gen3:path2_e",
		"gen3:path2_se",
		"gen3:path2_s",
		"gen3:path2_sw",
		"gen3:path2_w",
		"gen3:path2_nw",
		"gen3:path2_center",
		"gen3:ledge_end_sw",
		"gen3:ledge_end_se",
		"gen3:ledge_mid_s",
		"gen3:path2_sw_inside",
		"gen3:path2_se_inside"
	],
	
	"movement_pallet": [
		{"entry":0,"exit":0,"modes":0},
		{"entry":15,"exit":15,"modes":15},
		{"entry":1,"exit":4,"modes":15,"force_move":[180, 1, "jump"]}
	],
	
	"tile_layers": [
		[[4, 3, 4, 3, 4, 3, 4, 3, 4, 3, 4, 3,13,13,13,13],
		 [1, 2, 4, 3, 4, 3, 4, 3, 4, 3, 4, 3,13,13,13,13],
		 [4, 3, 1, 2, 1, 2, 1, 2, 1, 2, 1, 2,13,13,13,13],
		 [1, 2, 4,11, 4,11, 4,10, 9,10, 9,10,13,13,13,13],
		 [4, 3,11, 9,11, 4,12, 3, 4, 3, 4, 3,13,13,13,13],
		 [1, 2,24,18,18,18,18,18,18,18,18,18,18,18,18,18],
		 [4, 3,22,21,21,21,21,21,21,21,21,29,25,25,30,21],
		 [1, 2, 9, 9, 9, 9, 9,10,10,16, 9,23,25,25,19, 9],
		 [4, 3,12,10,13,13,13,13,13,13,13,23,25,25,19, 9],
		 [1, 2,12, 3,13,13,13,13,13,13,13,23,25,25,19, 4],
		 [4, 3,13,13,13,13,13,13,13,10,11,22,21,21,20,13],
		 [1, 2,13,13,13,13,13,13,13,11, 9,10,13,13, 9,13],
		 [4, 3, 3, 3, 3, 3, 3, 3, 3, 3, 3,10,13,13, 9, 3],
		 [1, 2, 4, 3, 4, 3, 4, 3, 4, 3, 4, 3,13,13, 4, 3],
		 [4, 3, 4, 3, 4, 3, 4, 3, 4, 3, 4, 3,13,13, 4, 3],
		 [1, 2, 1, 2, 1, 2, 1, 2, 1, 2, 1, 2,13,13, 1, 2]],
		 
		[[5, 6, 0, 0, 0, 0, 0, 0, 0, 0, 0, 0, 0, 0, 0, 0],
		 [0, 0, 5, 6, 5, 6, 5, 6, 5, 6, 5, 6, 0, 0, 0, 0],
		 [5, 6, 0, 0, 0, 0, 0, 0, 0, 0, 0, 0, 0, 0, 0, 0],
		 [0, 0, 0,15, 0,15, 0, 0, 0, 0, 0, 0, 0, 0, 0, 0],
		 [5, 6,15, 0,15, 0, 0, 0, 0, 0, 0, 0, 0, 0, 0, 0],
		 [0, 0, 0, 0, 0, 0, 0, 0, 0, 0, 0, 0, 0, 0, 0, 0],
		 [5, 6, 0, 0, 0, 0, 0, 0, 0, 0, 0, 0, 0, 0, 0, 0],
		 [0, 0,26,28,28,27, 0, 0, 0, 0,26,28,28,28,28,28],
		 [5, 6, 0, 0, 0, 0, 0, 0, 0, 0, 0, 0, 0, 0, 0, 0],
		 [0, 0, 0, 0, 0, 0, 0, 0, 0, 0, 0, 0, 0, 0, 0, 0],
		 [5, 6, 0, 0, 0, 0, 0, 0, 0, 0,15, 0, 0, 0, 0, 0],
		 [0, 0, 0, 0, 0, 0, 0, 0, 0,15, 0, 0, 0, 0, 0, 0],
		 [5, 6,14,14,14,14,14,14,14,14,14, 0, 0, 0, 0,14],
		 [0, 0, 0, 0, 0, 0, 0, 0, 0, 0, 0, 0, 0, 0, 0, 0],
		 [5, 6, 5, 6, 5, 6, 5, 6, 5, 6, 5, 6, 0, 0, 5, 6],
		 [0, 0, 0, 0, 0, 0, 0, 0, 0, 0, 0, 0, 0, 0, 0, 0]],
		 
		[[0, 0, 7, 8, 7, 8, 7, 8, 7, 8, 7, 8,17,17,17,17],
		 [7, 8, 0, 0, 0, 0, 0, 0, 0, 0, 0, 0,17,17,17,17],
		 [0, 0, 0, 0, 0, 0, 0, 0, 0, 0, 0, 0,17,17,17,17],
		 [7, 8, 0, 0, 0, 0, 0, 0, 0, 0, 0, 0,17,17,17,17],
		 [0, 0, 0, 0, 0, 0, 0, 0, 0, 0, 0, 0,17,17,17,17],
		 [7, 8, 0, 0, 0, 0, 0, 0, 0, 0, 0, 0, 0, 0, 0, 0],
		 [0, 0, 0, 0, 0, 0, 0, 0, 0, 0, 0, 0, 0, 0, 0, 0],
		 [7, 8, 0, 0, 0, 0, 0, 0, 0, 0, 0, 0, 0, 0, 0, 0],
		 [0, 0, 0, 0,17,17,17,17,17,17,17, 0, 0, 0, 0, 0],
		 [7, 8, 0, 0,17,17,17,17,17,17,17, 0, 0, 0, 0, 0],
		 [0, 0,17,17,17,17,17,17,17, 0, 0, 0, 0, 0, 0,17],
		 [7, 8,17,17,17,17,17,17,17, 0, 0, 0,17,17, 0,17],
		 [0, 0, 0, 0, 0, 0, 0, 0, 0, 0, 0, 0,17,17, 0, 0],
		 [7, 8, 7, 8, 7, 8, 7, 8, 7, 8, 7, 8,17,17, 7, 8],
		 [0, 0, 0, 0, 0, 0, 0, 0, 0, 0, 0, 0,17,17, 0, 0],
		 [7, 8, 7, 8, 7, 8, 7, 8, 7, 8, 7, 8,17,17, 7, 8]]
	],
	
	"movement": [
		[0, 0, 1, 1, 1, 1, 1, 1, 1, 1, 1, 1, 1, 1, 1, 1],
		[0, 0, 0, 0, 0, 0, 0, 0, 0, 0, 0, 0, 1, 1, 1, 1],
		[0, 0, 0, 0, 0, 0, 0, 0, 0, 0, 0, 0, 1, 1, 1, 1],
		[0, 0, 1, 1, 1, 1, 1, 1, 1, 1, 0, 1, 1, 1, 1, 1],
		[0, 0, 1, 1, 1, 1, 1, 1, 1, 1, 1, 1, 1, 1, 1, 1],
		[0, 0, 1, 1, 1, 1, 1, 1, 1, 1, 1, 1, 1, 1, 1, 1],
		[0, 0, 1, 1, 1, 1, 1, 1, 1, 1, 1, 1, 1, 1, 1, 1],
		[0, 0, 2, 2, 2, 2, 1, 1, 1, 0, 2, 2, 2, 2, 2, 2],
		[0, 0, 1, 1, 1, 1, 1, 1, 1, 1, 1, 1, 1, 1, 1, 1],
		[0, 0, 1, 1, 1, 1, 1, 1, 1, 1, 1, 1, 1, 1, 1, 1],
		[0, 0, 1, 1, 1, 1, 1, 1, 1, 1, 1, 1, 1, 1, 1, 1],
		[0, 0, 1, 1, 1, 1, 1, 1, 1, 1, 1, 1, 1, 1, 1, 1],
		[0, 0, 0, 0, 0, 0, 0, 0, 0, 0, 0, 0, 1, 1, 0, 0],
		[0, 0, 1, 1, 1, 1, 1, 1, 1, 1, 1, 0, 1, 1, 0, 1],
		[0, 0, 0, 0, 0, 0, 0, 0, 0, 0, 0, 0, 1, 1, 0, 0],
		[0, 0, 0, 0, 0, 0, 0, 0, 0, 0, 0, 0, 1, 1, 0, 0]
	]
}