{
	"entity_layer": 1,
	
	"tile_pallet": [
		"gen3:void",
		"gen3:tree_md_bottomleft",
		"gen3:tree_md_bottomright",
		"gen3:grass1_variant1",
		"gen3:grass1_variant2",
		"gen3:tree_md_midleft_nobg",
		"gen3:tree_md_midright_nobg",
		"gen3:tree_md_topleft_nobg",
		"gen3:tree_md_topright_nobg",
		"gen3:path1_outsidecorner_topleft_thick",
		"gen3:path1_outsidecorner_topright_thick",
		"gen3:path1_side_left_thick",
		"gen3:path1_center",
		"gen3:path1_side_right_thick",
		"gen3:path1_side_top_thick",
		"gen3:path1_insidecorner_topleft_thick_variant1",
		"gen3:path1_insidecorner_topright_thick",
		"gen3:path1_insidecorner_bottomright_thin",
		"gen3:path1_insidecorner_bottomleft_thin",
		"gen3:path1_side_bottom_thin",
		"gen3:path1_side_right_thin",
		"gen3:path1_insidecorner_topright_thickthin",
		"gen3:path1_insidecorner_topleft_thickthin",
		"gen3:path1_side_left_thin",
		"gen3:grass1_variant5",
		"gen3:path1_side_bottom_thin_variant2",
		"gen3:grass1_variant3",
		"gen3:grass1_variant4",
		"gen3:fence1_horizontal",
		"gen3:sign1",
		"gen3:sign2",
		"gen3:flower1",
		"gen3:mailbox1_part1",
		"gen3:mailbox1_part2",
		"gen3:house1_roof_red_n",
		"gen3:house1_roof_red_nw",
		"gen3:house1_roof_red_ne",
		"gen3:house1_roof_red_w",
		"gen3:house1_roof_red",
		"gen3:house1_roof_red_e",
		"gen3:house1_roof_red_sw",
		"gen3:house1_roof_red_s",
		"gen3:house1_roof_red_se",
		"gen3:house1_wall_w2",
		"gen3:house1_wall_w1",
		"gen3:house1_wall_2_part1",
		"gen3:house1_wall_2_part2",
		"gen3:house1_wall_2_part3",
		"gen3:house1_wall_e2",
		"gen3:house1_wall_e1",
		"gen3:house1_wall_1_part2",
		"gen3:house1_wall_1_part1",
		"gen3:house1_door1_red",
		"gen3:lab1_roof_nw",
		"gen3:lab1_roof_n",
		"gen3:lab1_roof_w",
		"gen3:lab1_roof",
		"gen3:lab1_roof_sw",
		"gen3:lab1_roof_s",
		"gen3:lab1_wall_2_part1",
		"gen3:lab1_wall_2_part2",
		"gen3:lab1_wall_2_part3",
		"gen3:lab1_wall_1_part1",
		"gen3:lab1_wall_1_part2",
		"gen3:lab1_wall_1_part3"
	],
	
	"movement_pallet": [
		{"entry":15,"exit":15,"modes":15},
		{"entry":0,"exit":0,"modes":0}
	],
	
	"tile_layers": [
		[[4, 3, 4, 3, 4, 3, 4, 3, 4, 3, 4, 3, 9,10, 4, 3],
		 [1, 2, 1, 2, 1, 2, 1, 2, 1, 2, 1, 2,11,13, 1, 2],
		 [4, 3, 9,14,14,14,14,14,14,14,14,14,15,16,14,14],
		 [1, 2,11,12,12,12,12,12,12,12,12,12,12,12,12,12],
		 [4, 3,11,17,19,24,24,24,24,24,18,12,17,19,24,24],
		 [1, 2,11,20, 3,24,24,24,24,24,23,12,20, 3,24,24],
		 [4, 3,11,20,24,24,24,24,24,24,23,12,20,24,24,24],
		 [1, 2,11,20,24,24,24,24,24,24,23,12,20,24,24,24],
		 [4, 3,11,21,14,22,12,21,14,14,22,12,21,14,22,12],
		 [1, 2,11,12,12,12,12,12,12,12,12,12,12,12,12,12],
		 [4, 3,11,12,12,12,12,12,12,12,12,12,17,55,56,56],
		 [1, 2,11,12,17,25,25,25,25,24,18,12,20,57,58,58],
		 [4, 3,11,12,20,26,26,26,26, 3,23,12,20,59,60,61],
		 [1, 2,11,12,20,26,26,26,26,26,23,12,20,62,63,64],
		 [4, 3,11,12,20,24,27, 3,27, 3,23,12,21,14,14,22],
		 [1, 2,11,12,21,14,14,14,14,14,22,12,17,19,19,19]],
		 
		[[5, 6, 5, 6, 5, 6, 5, 6, 5, 6, 5, 6, 0, 0, 5, 6],
		 [0, 0, 0, 0, 0, 0, 0, 0, 0, 0, 0, 0, 0, 0, 0, 0],
		 [5, 6, 0, 0, 0, 0, 0, 0, 0, 0, 0, 0, 0, 0, 0, 0],
		 [0, 0, 0, 0, 0, 0, 0, 0, 0, 0, 0, 0, 0, 0, 0, 0],
		 [5, 6, 0, 0, 0,37,38,38,38,39, 0, 0, 0, 0,37,38],
		 [0, 0, 0, 0, 0,40,41,41,41,42, 0, 0, 0, 0,40,41],
		 [5, 6, 0, 0, 0,43,45,46,47,48, 0, 0, 0, 0,43,45],
		 [0, 0, 0, 0,32,44,52,51,50,49, 0, 0, 0,32,44,52],
		 [5, 6, 0, 0, 0, 0, 0, 0, 0, 0, 0, 0, 0, 0, 0, 0],
		 [0, 0, 0, 0, 0, 0, 0, 0, 0, 0, 0, 0, 0, 0, 0, 0],
		 [5, 6, 0, 0, 0, 0, 0, 0, 0, 0, 0, 0, 0, 0, 0, 0],
		 [0, 0, 0, 0, 0,28,28,28,28,29, 0, 0, 0, 0, 0, 0],
		 [5, 6, 0, 0, 0,31,31,31,31, 0, 0, 0, 0, 0, 0, 0],
		 [0, 0, 0, 0, 0,31,31,31,31, 0, 0, 0, 0, 0, 0, 0],
		 [5, 6, 0, 0, 0,30, 0, 0, 0, 0, 0, 0, 0, 0, 0, 0],
		 [0, 0, 0, 0, 0, 0, 0, 0, 0, 0, 0, 0, 0, 0, 0, 0]],
		 
		[[0, 0, 0, 0, 0, 0, 0, 0, 0, 0, 0, 0, 0, 0, 0, 0],
		 [7, 8, 0, 0, 0, 0, 0, 0, 0, 0, 0, 0, 0, 0, 0, 0],
		 [0, 0, 0, 0, 0, 0, 0, 0, 0, 0, 0, 0, 0, 0, 0, 0],
		 [7, 8, 0, 0, 0,35,34,34,34,36, 0, 0, 0, 0,35,34],
		 [0, 0, 0, 0, 0, 0, 0, 0, 0, 0, 0, 0, 0, 0, 0, 0],
		 [7, 8, 0, 0, 0, 0, 0, 0, 0, 0, 0, 0, 0, 0, 0, 0],
		 [0, 0, 0, 0,33, 0, 0, 0, 0, 0, 0, 0, 0,33, 0, 0],
		 [7, 8, 0, 0, 0, 0, 0, 0, 0, 0, 0, 0, 0, 0, 0, 0],
		 [0, 0, 0, 0, 0, 0, 0, 0, 0, 0, 0, 0, 0, 0, 0, 0],
		 [7, 8, 0, 0, 0, 0, 0, 0, 0, 0, 0, 0, 0,53,54,54],
		 [0, 0, 0, 0, 0, 0, 0, 0, 0, 0, 0, 0, 0, 0, 0, 0],
		 [7, 8, 0, 0, 0, 0, 0, 0, 0, 0, 0, 0, 0, 0, 0, 0],
		 [0, 0, 0, 0, 0, 0, 0, 0, 0, 0, 0, 0, 0, 0, 0, 0],
		 [7, 8, 0, 0, 0, 0, 0, 0, 0, 0, 0, 0, 0, 0, 0, 0],
		 [0, 0, 0, 0, 0, 0, 0, 0, 0, 0, 0, 0, 0, 0, 0, 0],
		 [7, 8, 0, 0, 0, 0, 0, 0, 0, 0, 0, 0, 0, 0, 0, 0]]
	],
	
	"movement": [
		[1, 1, 1, 1, 1, 1, 1, 1, 1, 1, 1, 1, 0, 0, 1, 1],
		[1, 1, 1, 1, 1, 1, 1, 1, 1, 1, 1, 1, 0, 0, 1, 1],
		[1, 1, 0, 0, 0, 0, 0, 0, 0, 0, 0, 0, 0, 0, 0, 0],
		[1, 1, 0, 0, 0, 0, 0, 0, 0, 0, 0, 0, 0, 0, 0, 0],
		[1, 1, 0, 0, 0, 1, 1, 1, 1, 1, 0, 0, 0, 0, 1, 1],
		[1, 1, 0, 0, 0, 1, 1, 1, 1, 1, 0, 0, 0, 0, 1, 1],
		[1, 1, 0, 0, 0, 1, 1, 1, 1, 1, 0, 0, 0, 0, 1, 1],
		[1, 1, 0, 0, 1, 1, 1, 1, 1, 1, 0, 0, 0, 1, 1, 1],
		[1, 1, 0, 0, 0, 0, 0, 0, 0, 0, 0, 0, 0, 0, 0, 0],
		[1, 1, 0, 0, 0, 0, 0, 0, 0, 0, 0, 0, 0, 0, 0, 0],
		[1, 1, 0, 0, 0, 0, 0, 0, 0, 0, 0, 0, 0, 1, 1, 1],
		[1, 1, 0, 0, 0, 1, 1, 1, 1, 1, 0, 0, 0, 1, 1, 1],
		[1, 1, 0, 0, 0, 0, 0, 0, 0, 0, 0, 0, 0, 1, 1, 1],
		[1, 1, 0, 0, 0, 0, 0, 0, 0, 0, 0, 0, 0, 1, 1, 1],
		[1, 1, 0, 0, 0, 1, 0, 0, 0, 0, 0, 0, 0, 0, 0, 0],
		[1, 1, 0, 0, 0, 0, 0, 0, 0, 0, 0, 0, 0, 0, 0, 0]
	]
}