{
	"entity_layer": 1,
	
	"tile_pallet": [
		"gen3:void",
		"gen3:grass1_variant1",
		"gen3:grass1_variant2",
		"gen3:grass1_variant3",
		"gen3:grass1_variant4",
		"gen3:grass1_variant5",
		"gen3:grass1_variant6",
		"gen3:tree_md_bottomleft",
		"gen3:tree_md_bottomright",
		"gen3:tree_md_midleft_nobg",
		"gen3:tree_md_midright_nobg",
		"gen3:tree_md_topleft_nobg",
		"gen3:tree_md_topright_nobg",
		"gen3:tallgrass1_base",
		"gen3:tallgrass1_top",
		"gen3:path2_n",
		"gen3:path2_ne",
		"gen3:path2_ne_inside",
		"gen3:path2_e",
		"gen3:path2_se",
		"gen3:path2_se_inside",
		"gen3:path2_s",
		"gen3:path2_sw",
		"gen3:path2_w",
		"gen3:path2_nw",
		"gen3:path2_nw_inside",
		"gen3:path2_center",
		"gen3:ledge_end_sw",
		"gen3:ledge_end_se",
		"gen3:ledge_mid_s",
		"gen3:flower1"
	],
	
	"movement_pallet": [
		{"entry":0,"exit":0,"modes":0},
		{"entry":15,"exit":15,"modes":15},
		{"entry":1,"exit":4,"modes":15,"force_move":[{"trigger":"entering","type":"jump","direction":180,"distance":1}]}
	],
	
	"tile_layers": [
		[[ 2, 1, 6, 5, 2, 1, 6, 5, 2, 1,13,13,13,13,13,13],
		 [ 7, 8, 5, 6, 3, 4, 5, 6, 7, 8,13,13,13,13,13,13],
		 [ 2, 1, 3, 3, 3, 3, 3, 3, 2, 1,13,13,13,13,13,13],
		 [ 7, 8, 2, 5, 2, 1, 2, 1, 7, 8, 1, 3, 1,24,15,15],
		 [ 2, 1, 5, 2, 3, 2, 3, 2, 1, 3, 4, 4, 3,23,26,20],
		 [ 7, 8, 2, 5, 2, 1, 2, 1, 3, 2, 1, 1, 2,22,21,19],
		 [ 2, 1, 2, 1, 2, 1, 2, 1, 2, 1, 2, 1, 2, 1, 2, 1],
		 [ 7, 8, 2, 1, 3, 3, 3, 3, 3, 3, 2, 1, 2, 1, 2, 1],
		 [ 2, 1, 7, 8, 3, 1, 3, 1, 3, 1, 7, 8, 7, 8, 7, 8],
		 [ 7, 8, 1, 3, 1, 3, 1, 3, 1, 3, 1, 3, 1,24,15,16],
		 [ 2, 1, 2, 1, 2,24,15,15,15,15,15,15,15,25,26,18],
		 [ 7, 8, 3, 4, 3,23,26,26,20,21,21,21,21,21,21,19],
		 [ 2, 1, 3, 3, 3,23,26,26,18, 3, 1, 3, 3, 3, 3, 3],
		 [ 7, 8, 3, 4, 2,23,26,26,17,15,15,15,15,15,15,15],
		 [ 2, 1, 3, 4, 3,22,21,21,21,21,21,21,21,21,21,21],
		 [ 7, 8, 2, 1, 2, 1, 2, 1, 2, 1, 2, 1, 2, 1, 2, 1]],
		 
		[[ 9,10, 0,30, 0, 0, 0,30, 9,10, 0, 0, 0, 0, 0, 0],
		 [ 0, 0,30, 0, 0, 0,30, 0, 0, 0, 0, 0, 0, 0, 0, 0],
		 [ 9,10,27,29,29,29,29,28, 9,10, 0, 0, 0, 0, 0, 0],
		 [ 0, 0, 0,30, 0, 0, 0, 0, 0, 0, 0, 0, 0, 0, 0, 0],
		 [ 9,10,30, 0, 0, 0, 0, 0, 0, 0, 0, 0, 0, 0, 0, 0],
		 [ 0, 0, 0,30, 0, 0, 0, 0, 0, 0, 0, 0, 0, 0, 0, 0],
		 [ 9,10, 0, 0, 0, 0, 0, 0, 0, 0, 0, 0, 0, 0, 0, 0],
		 [ 0, 0, 9,10,27,29,29,29,29,28, 9,10, 9,10, 9,10],
		 [ 9,10, 0, 0, 0, 0, 0, 0, 0, 0, 0, 0, 0, 0, 0, 0],
		 [ 0, 0, 0, 0, 0, 0, 0, 0, 0, 0, 0, 0, 0, 0, 0, 0],
		 [ 9,10, 0, 0, 0, 0, 0, 0, 0, 0, 0, 0, 0, 0, 0, 0],
		 [ 0, 0, 0, 0, 0, 0, 0, 0, 0, 0, 0, 0, 0, 0, 0, 0],
		 [ 9,10,27,28, 0,27,29,29,28, 0, 0,27,29,29,29,28],
		 [ 0, 0, 0, 0, 0, 0, 0, 0, 0, 0, 0, 0, 0, 0, 0, 0],
		 [ 9,10, 0, 0, 0, 0, 0, 0, 0, 0, 0, 0, 0, 0, 0, 0],
		 [ 0, 0, 0, 0, 0, 0, 0, 0, 0, 0, 0, 0, 0, 0, 0, 0]],
		 
		[[ 0, 0, 0, 0, 0, 0, 0, 0, 0, 0,14,14,14,14,14,14],
		 [11,12, 0, 0, 0, 0, 0, 0,11,12,14,14,14,14,14,14],
		 [ 0, 0, 0, 0, 0, 0, 0, 0, 0, 0,14,14,14,14,14,14],
		 [11,12, 0, 0, 0, 0, 0, 0, 0, 0, 0, 0, 0, 0, 0, 0],
		 [ 0, 0, 0, 0, 0, 0, 0, 0, 0, 0, 0, 0, 0, 0, 0, 0],
		 [11,12, 0, 0, 0, 0, 0, 0, 0, 0, 0, 0, 0, 0, 0, 0],
		 [ 0, 0,11,12, 0, 0, 0, 0, 0, 0,11,12,11,12,11,12],
		 [11,12, 0, 0, 0, 0, 0, 0, 0, 0, 0, 0, 0, 0, 0, 0],
		 [ 0, 0, 0, 0, 0, 0, 0, 0, 0, 0, 0, 0, 0, 0, 0, 0],
		 [11,12, 0, 0, 0, 0, 0, 0, 0, 0, 0, 0, 0, 0, 0, 0],
		 [ 0, 0, 0, 0, 0, 0, 0, 0, 0, 0, 0, 0, 0, 0, 0, 0],
		 [11,12, 0, 0, 0, 0, 0, 0, 0, 0, 0, 0, 0, 0, 0, 0],
		 [ 0, 0, 0, 0, 0, 0, 0, 0, 0, 0, 0, 0, 0, 0, 0, 0],
		 [11,12, 0, 0, 0, 0, 0, 0, 0, 0, 0, 0, 0, 0, 0, 0],
		 [ 0, 0, 0, 0, 0, 0, 0, 0, 0, 0, 0, 0, 0, 0, 0, 0],
		 [11,12, 0, 0, 0, 0, 0, 0, 0, 0, 0, 0, 0, 0, 0, 0]]
	],
	
	"movement": [
		[ 0, 0, 1, 1, 1, 1, 1, 1, 0, 0, 1, 1, 1, 1, 1, 1],
		[ 0, 0, 1, 1, 1, 1, 1, 1, 0, 0, 1, 1, 1, 1, 1, 1],
		[ 0, 0, 2, 2, 2, 2, 2, 2, 0, 0, 1, 1, 1, 1, 1, 1],
		[ 0, 0, 1, 1, 1, 1, 1, 1, 0, 0, 1, 1, 1, 1, 1, 1],
		[ 0, 0, 1, 1, 1, 1, 1, 1, 1, 1, 1, 1, 1, 1, 1, 1],
		[ 0, 0, 1, 1, 1, 1, 1, 1, 1, 1, 1, 1, 1, 1, 1, 1],
		[ 0, 0, 1, 1, 1, 1, 1, 1, 1, 1, 1, 1, 1, 1, 1, 1],
		[ 0, 0, 0, 0, 2, 2, 2, 2, 2, 2, 0, 0, 0, 0, 0, 0],
		[ 0, 0, 0, 0, 1, 1, 1, 1, 1, 1, 0, 0, 0, 0, 0, 0],
		[ 0, 0, 1, 1, 1, 1, 1, 1, 1, 1, 1, 1, 1, 1, 1, 1],
		[ 0, 0, 1, 1, 1, 1, 1, 1, 1, 1, 1, 1, 1, 1, 1, 1],
		[ 0, 0, 1, 1, 1, 1, 1, 1, 1, 1, 1, 1, 1, 1, 1, 1],
		[ 0, 0, 2, 2, 1, 2, 2, 2, 2, 1, 1, 2, 2, 2, 2, 2],
		[ 0, 0, 1, 1, 1, 1, 1, 1, 1, 1, 1, 1, 1, 1, 1, 1],
		[ 0, 0, 1, 1, 1, 1, 1, 1, 1, 1, 1, 1, 1, 1, 1, 1],
		[ 0, 0, 1, 1, 1, 1, 1, 1, 1, 1, 1, 1, 1, 1, 1, 1]
	]
}