{
	"entity_layer": 1,
	
	"tile_pallet": [
		"gen3:void",
		"gen3:grass1_variant1",
		"gen3:grass1_variant2",
		"gen3:grass1_variant3",
		"gen3:grass1_variant4",
		"gen3:grass1_variant5",
		"gen3:grass1_variant6",
		"gen3:tree_md_bottomleft",
		"gen3:tree_md_bottomright",
		"gen3:tree_md_midleft_nobg",
		"gen3:tree_md_midright_nobg",
		"gen3:tree_md_topleft_nobg",
		"gen3:tree_md_topright_nobg",
		"gen3:tallgrass1_base",
		"gen3:tallgrass1_top",
		"gen3:path2_n",
		"gen3:path2_nw_inside",
		"gen3:path2_e",
		"gen3:path2_se",
		"gen3:path2_s",
		"gen3:path2_w",
		"gen3:path2_center",
		"gen3:ledge_end_sw",
		"gen3:ledge_end_se",
		"gen3:ledge_mid_s",
		"gen3:flower1",
		"gen3:fence1_horizontal"
	],
	
	"movement_pallet": [
		{"entry":0,"exit":0,"modes":0},
		{"entry":15,"exit":15,"modes":15},
		{"entry":1,"exit":4,"modes":15,"force_move":[{"trigger":"entering","type":"jump","direction":180,"distance":1}]}
	],
	
	"tile_layers": [
		[[13,13,20,21,21,17,2, 1, 2, 1, 2, 1, 2, 1, 2, 1],
		 [13,13,20,21,21,17,7, 8, 7, 8, 7, 8, 7, 8, 7, 8],
		 [13,13,20,21,21,17,2, 1, 2, 1, 2, 1, 2, 1, 2, 1],
		 [13,13,20,21,21,17,7, 8, 7, 8, 7, 8, 7, 8, 7, 8],
		 [13,13,20,21,21,17,2, 1, 2, 1, 2, 1, 2, 1, 2, 1],
		 [15,15,16,21,21,17,7, 8, 7, 8, 7, 8, 7, 8, 7, 8],
		 [19,19,19,19,19,18,2, 1, 2, 1, 2, 1, 2, 1, 2, 1],
		 [3, 3, 3, 3, 3, 3, 7, 8, 7, 8, 7, 8, 7, 8, 7, 8],
		 [4,13,13,13,13,13, 2, 1, 2, 1, 2, 1, 2, 1, 2, 1],
		 [1,13,13,13,13,13, 7, 8, 7, 8, 7, 8, 7, 8, 7, 8],
		 [13,13,13,13,5, 3, 2, 1, 2, 1, 2, 1, 2, 1, 2, 1],
		 [13,13,13,13,4, 5, 7, 8, 7, 8, 7, 8, 7, 8, 7, 8],
		 [1, 1, 1, 1, 1, 1, 2, 1, 2, 1, 2, 1, 2, 1, 2, 1],
		 [2, 1, 2, 1, 2, 1, 7, 8, 7, 8, 7, 8, 7, 8, 7, 8],
		 [2, 1, 2, 1, 2, 1, 2, 1, 2, 1, 2, 1, 2, 1, 2, 1],
		 [7, 8, 7, 8, 7, 8, 7, 8, 7, 8, 7, 8, 7, 8, 7, 8]],
		 
		[[0, 0, 0, 0, 0, 0, 9,10, 9,10, 9,10, 9,10, 9,10],
		 [0, 0, 0, 0, 0, 0, 0, 0, 0, 0, 0, 0, 0, 0, 0, 0],
		 [0, 0,22,24,24,23, 9,10, 9,10, 9,10, 9,10, 9,10],
		 [0, 0, 0, 0, 0, 0, 0, 0, 0, 0, 0, 0, 0, 0, 0, 0],
		 [0, 0, 0, 0, 0, 0, 9,10, 9,10, 9,10, 9,10, 9,10],
		 [0, 0, 0, 0, 0, 0, 0, 0, 0, 0, 0, 0, 0, 0, 0, 0],
		 [0, 0, 0, 0, 0, 0, 9,10, 9,10, 9,10, 9,10, 9,10],
		 [24,24,24,24,24,23,0, 0, 0, 0, 0, 0, 0, 0, 0, 0],
		 [0, 0, 0, 0, 0, 0, 9,10, 9,10, 9,10, 9,10, 9,10],
		 [0, 0, 0, 0, 0, 0, 0, 0, 0, 0, 0, 0, 0, 0, 0, 0],
		 [0, 0, 0, 0,25, 0, 9,10, 9,10, 9,10, 9,10, 9,10],
		 [0, 0, 0, 0, 0,25, 0, 0, 0, 0, 0, 0, 0, 0, 0, 0],
		 [26,26,26,26,26,26,9,10, 9,10, 9,10, 9,10, 9,10],
		 [0, 0, 0, 0, 0, 0, 0, 0, 0, 0, 0, 0, 0, 0, 0, 0],
		 [9,10, 9,10, 9,10, 9,10, 9,10, 9,10, 9,10, 9,10],
		 [0, 0, 0, 0, 0, 0, 0, 0, 0, 0, 0, 0, 0, 0, 0, 0]],
		 
		[[14,14,0, 0, 0, 0, 0, 0, 0, 0, 0, 0, 0, 0, 0, 0],
		 [14,14,0, 0, 0, 0,11,12,11,12,11,12,11,12,11,12],
		 [14,14,0, 0, 0, 0, 0, 0, 0, 0, 0, 0, 0, 0, 0, 0],
		 [14,14,0, 0, 0, 0,11,12,11,12,11,12,11,12,11,12],
		 [14,14,0, 0, 0, 0, 0, 0, 0, 0, 0, 0, 0, 0, 0, 0],
		 [0, 0, 0, 0, 0, 0,11,12,11,12,11,12,11,12,11,12],
		 [0, 0, 0, 0, 0, 0, 0, 0, 0, 0, 0, 0, 0, 0, 0, 0],
		 [0, 0, 0, 0, 0, 0,11,12,11,12,11,12,11,12,11,12],
		 [0,14,14,14,14,14, 0, 0, 0, 0, 0, 0, 0, 0, 0, 0],
		 [0,14,14,14,14,14,11,12,11,12,11,12,11,12,11,12],
		 [14,14,14,14,0, 0, 0, 0, 0, 0, 0, 0, 0, 0, 0, 0],
		 [14,14,14,14,0, 0,11,12,11,12,11,12,11,12,11,12],
		 [0, 0, 0, 0, 0, 0, 0, 0, 0, 0, 0, 0, 0, 0, 0, 0],
		 [11,12,11,12,11,12,11,12,11,12,11,12,11,12,11,12],
		 [0, 0, 0, 0, 0, 0, 0, 0, 0, 0, 0, 0, 0, 0, 0, 0],
		 [11,12,11,12,11,12,11,12,11,12,11,12,11,12,11,12]]
	],
	
	"movement": [
		[1, 1, 1, 1, 1, 1, 0, 0, 0, 0, 0, 0, 0, 0, 0, 0],
		[1, 1, 1, 1, 1, 1, 0, 0, 0, 0, 0, 0, 0, 0, 0, 0],
		[1, 1, 2, 2, 2, 2, 0, 0, 0, 0, 0, 0, 0, 0, 0, 0],
		[1, 1, 1, 1, 1, 1, 0, 0, 0, 0, 0, 0, 0, 0, 0, 0],
		[1, 1, 1, 1, 1, 1, 0, 0, 0, 0, 0, 0, 0, 0, 0, 0],
		[1, 1, 1, 1, 1, 1, 0, 0, 0, 0, 0, 0, 0, 0, 0, 0],
		[1, 1, 1, 1, 1, 1, 0, 0, 0, 0, 0, 0, 0, 0, 0, 0],
		[2, 2, 2, 2, 2, 2, 0, 0, 0, 0, 0, 0, 0, 0, 0, 0],
		[1, 1, 1, 1, 1, 1, 0, 0, 0, 0, 0, 0, 0, 0, 0, 0],
		[1, 1, 1, 1, 1, 1, 0, 0, 0, 0, 0, 0, 0, 0, 0, 0],
		[1, 1, 1, 1, 1, 1, 0, 0, 0, 0, 0, 0, 0, 0, 0, 0],
		[1, 1, 1, 1, 1, 1, 0, 0, 0, 0, 0, 0, 0, 0, 0, 0],
		[0, 0, 0, 0, 0, 0, 0, 0, 0, 0, 0, 0, 0, 0, 0, 0],
		[1, 1, 1, 1, 1, 1, 0, 0, 0, 0, 0, 0, 0, 0, 0, 0],
		[0, 0, 0, 0, 0, 0, 0, 0, 0, 0, 0, 0, 0, 0, 0, 0],
		[0, 0, 0, 0, 0, 0, 0, 0, 0, 0, 0, 0, 0, 0, 0, 0]
	]
}